  10 . o x
..........
..o.......
..........
.....o....
..........
..........
....o.....
..........
..........
o.........
..........
